10 8
###  # ###
  #  ##   
 ##    ## 
 ### ###  
  #  ##   
 #   ### 
          
  ########
